Gender ,Age group,Voted A,Voted B,Refusal,Total
Male,20's,93,115,28,236
,30's,104,233,82,419
,40's,146,295,49,490
,50's,265,228,86,579
,60+,295,122,88,505
Female,20's,106,159,62,327
,30's,129,242,70,441
,40's,170,262,69,501
,50's,284,137,86,507
,60+,217,81,125,423
Total,,1809,1874,745,4428
